111111111
1000P0011
1E000C111
111111111