111111
1PE001
100001
10C001
111111