11111111111111111111111111111
1E000000000000C00000C00000011
10100101001000001010010001011
10100100101010100010010010101
1P1000000C00C00000000100C0001
11000011111100000000000000011
10000000101111100000C00000111
11111111111111111111111111111