1111111111111
10000000000C1
10100101C0011
100C010010101
1000PEC000011
1111111111111