11111111111111111111
10000000000000000001
10000000000111100001
10000000001111111101
11111111111111111111