11111111
10C0PE11
10000111
10000C01
11111111
