1111111111111111111111111111111111
100000000000000C00000C000000000001
101001010010000010100100E000010101
101001001010101000100100000P010101
100000000C00C0000000000000000000C1
1111111111111111111111111111111111