1111111111111
10110000000C1
1000011111001
1P1011E000000
1111111111111