1111111
10110C1
1P0E001
1111111